"filename", "language", "Ini", "Markdown", "C++", "C", "comment", "blank", "total"
"d:\GitRepo\README.md", "Markdown", 0, 36, 0, 0, 0, 12, 48
"d:\GitRepo\acwing\basic algorithm\binary-search.cpp", "C++", 0, 0, 44, 0, 2, 1, 47
"d:\GitRepo\acwing\basic algorithm\bit-op.cpp", "C++", 0, 0, 13, 0, 1, 1, 15
"d:\GitRepo\acwing\basic algorithm\discretization.cpp", "C++", 0, 0, 45, 0, 6, 1, 52
"d:\GitRepo\acwing\basic algorithm\double-pointer.cpp", "C++", 0, 0, 55, 0, 3, 1, 59
"d:\GitRepo\acwing\basic algorithm\high-accuracy.cpp", "C++", 0, 0, 111, 0, 4, 1, 116
"d:\GitRepo\acwing\basic algorithm\interval-merge.cpp", "C++", 0, 0, 29, 0, 1, 1, 31
"d:\GitRepo\acwing\basic algorithm\merge-sort.cpp", "C++", 0, 0, 53, 0, 6, 1, 60
"d:\GitRepo\acwing\basic algorithm\prefix-sum-diff.cpp", "C++", 0, 0, 91, 0, 4, 1, 96
"d:\GitRepo\acwing\basic algorithm\quick-sort.cpp", "C++", 0, 0, 49, 0, 2, 1, 52
"d:\GitRepo\acwing\data-structure\double-linked-list.cpp", "C++", 0, 0, 47, 0, 1, 1, 49
"d:\GitRepo\acwing\data-structure\kmp.cpp", "C++", 0, 0, 24, 0, 7, 1, 32
"d:\GitRepo\acwing\data-structure\monotonic-queue.cpp", "C++", 0, 0, 26, 0, 4, 1, 31
"d:\GitRepo\acwing\data-structure\monotonic-stack.cpp", "C++", 0, 0, 16, 0, 2, 1, 19
"d:\GitRepo\acwing\data-structure\queue.cpp", "C++", 0, 0, 22, 0, 1, 1, 24
"d:\GitRepo\acwing\data-structure\single-list.cpp", "C++", 0, 0, 45, 0, 1, 1, 47
"d:\GitRepo\acwing\data-structure\stack.cpp", "C++", 0, 0, 65, 0, 2, 1, 68
"d:\GitRepo\acwing\math\quick-pow.cpp", "C++", 0, 0, 22, 0, 1, 1, 24
"d:\GitRepo\acwing\search-graph-theory\bellman-ford.cpp", "C++", 0, 0, 32, 0, 1, 1, 34
"d:\GitRepo\acwing\search-graph-theory\bfs.cpp", "C++", 0, 0, 73, 0, 5, 1, 79
"d:\GitRepo\acwing\search-graph-theory\dfs.cpp", "C++", 0, 0, 88, 0, 10, 1, 99
"d:\GitRepo\acwing\search-graph-theory\dijkstra.cpp", "C++", 0, 0, 80, 0, 2, 1, 83
"d:\GitRepo\acwing\search-graph-theory\dye-binary-graph.cpp", "C++", 0, 0, 0, 0, 0, 1, 1
"d:\GitRepo\acwing\search-graph-theory\floyd.cpp", "C++", 0, 0, 32, 0, 1, 1, 34
"d:\GitRepo\acwing\search-graph-theory\hungarian.cpp", "C++", 0, 0, 0, 0, 0, 1, 1
"d:\GitRepo\acwing\search-graph-theory\kruskal.cpp", "C++", 0, 0, 0, 0, 0, 1, 1
"d:\GitRepo\acwing\search-graph-theory\prim.cpp", "C++", 0, 0, 0, 0, 0, 1, 1
"d:\GitRepo\acwing\search-graph-theory\spfa.cpp", "C++", 0, 0, 48, 0, 1, 1, 50
"d:\GitRepo\acwing\search-graph-theory\topo-sort.cpp", "C++", 0, 0, 0, 0, 0, 1, 1
"d:\GitRepo\acwing\search-graph-theory\tree-bfs.cpp", "C++", 0, 0, 38, 0, 2, 1, 41
"d:\GitRepo\acwing\search-graph-theory\tree-dfs.cpp", "C++", 0, 0, 37, 0, 2, 1, 40
"d:\GitRepo\archive\AtCoder\143\A.cpp", "C++", 0, 0, 13, 0, 0, 1, 14
"d:\GitRepo\archive\AtCoder\146\C.cpp", "C++", 0, 0, 39, 0, 1, 1, 41
"d:\GitRepo\archive\AtCoder\202\A.cpp", "C++", 0, 0, 14, 0, 0, 3, 17
"d:\GitRepo\archive\AtCoder\210\F.cpp", "C++", 0, 0, 27, 0, 0, 3, 30
"d:\GitRepo\archive\AtCoder\215\H.cpp", "C++", 0, 0, 36, 0, 2, 6, 44
"d:\GitRepo\archive\AtCoder\221\B.cpp", "C++", 0, 0, 30, 0, 0, 3, 33
"d:\GitRepo\archive\AtCoder\221\E.cpp", "C++", 0, 0, 26, 0, 0, 4, 30
"d:\GitRepo\archive\AtCoder\222\A.cpp", "C++", 0, 0, 15, 0, 0, 3, 18
"d:\GitRepo\archive\AtCoder\234\A.cpp", "C++", 0, 0, 19, 0, 0, 4, 23
"d:\GitRepo\archive\C++[class]\1 - 2022.9.8\1.c", "C", 0, 0, 0, 10, 0, 0, 10
"d:\GitRepo\archive\C++[class]\1 - 2022.9.8\10.c", "C", 0, 0, 0, 13, 0, 0, 13
"d:\GitRepo\archive\C++[class]\1 - 2022.9.8\2.c", "C", 0, 0, 0, 23, 0, 0, 23
"d:\GitRepo\archive\C++[class]\1 - 2022.9.8\3.c", "C", 0, 0, 0, 20, 0, 0, 20
"d:\GitRepo\archive\C++[class]\1 - 2022.9.8\4.c", "C", 0, 0, 0, 29, 3, 0, 32
"d:\GitRepo\archive\C++[class]\1 - 2022.9.8\5.c", "C", 0, 0, 0, 22, 3, 0, 25
"d:\GitRepo\archive\C++[class]\1 - 2022.9.8\6.c", "C", 0, 0, 0, 25, 3, 0, 28
"d:\GitRepo\archive\C++[class]\1 - 2022.9.8\7.c", "C", 0, 0, 0, 56, 9, 0, 65
"d:\GitRepo\archive\C++[class]\1 - 2022.9.8\8.c", "C", 0, 0, 0, 28, 6, 0, 34
"d:\GitRepo\archive\C++[class]\1 - 2022.9.8\9.c", "C", 0, 0, 0, 31, 8, 0, 39
"d:\GitRepo\archive\C++[class]\2 - 2022.9.15\1.cpp", "C++", 0, 0, 16, 0, 0, 0, 16
"d:\GitRepo\archive\C++[class]\2 - 2022.9.15\10.cpp", "C++", 0, 0, 47, 0, 0, 0, 47
"d:\GitRepo\archive\C++[class]\2 - 2022.9.15\2.cpp", "C++", 0, 0, 9, 0, 0, 2, 11
"d:\GitRepo\archive\C++[class]\2 - 2022.9.15\3.cpp", "C++", 0, 0, 44, 0, 0, 0, 44
"d:\GitRepo\archive\C++[class]\2 - 2022.9.15\4.cpp", "C++", 0, 0, 36, 0, 0, 0, 36
"d:\GitRepo\archive\C++[class]\2 - 2022.9.15\5.cpp", "C++", 0, 0, 63, 0, 0, 0, 63
"d:\GitRepo\archive\C++[class]\2 - 2022.9.15\6.cpp", "C++", 0, 0, 25, 0, 0, 0, 25
"d:\GitRepo\archive\C++[class]\2 - 2022.9.15\7.cpp", "C++", 0, 0, 17, 0, 0, 0, 17
"d:\GitRepo\archive\C++[class]\2 - 2022.9.15\8.cpp", "C++", 0, 0, 36, 0, 0, 0, 36
"d:\GitRepo\archive\C++[class]\2 - 2022.9.15\9.cpp", "C++", 0, 0, 18, 0, 0, 0, 18
"d:\GitRepo\archive\C++[class]\3 - 2022.9.22\1.cpp", "C++", 0, 0, 10, 0, 0, 0, 10
"d:\GitRepo\archive\C++[class]\3 - 2022.9.22\2.cpp", "C++", 0, 0, 26, 0, 0, 0, 26
"d:\GitRepo\archive\C++[class]\3 - 2022.9.22\3.cpp", "C++", 0, 0, 16, 0, 0, 0, 16
"d:\GitRepo\archive\C++[class]\3 - 2022.9.22\4.cpp", "C++", 0, 0, 20, 0, 0, 0, 20
"d:\GitRepo\archive\C++[class]\3 - 2022.9.22\5.cpp", "C++", 0, 0, 18, 0, 2, 0, 20
"d:\GitRepo\archive\C++[class]\3 - 2022.9.22\6.cpp", "C++", 0, 0, 33, 0, 0, 0, 33
"d:\GitRepo\archive\C++[class]\3 - 2022.9.22\7.cpp", "C++", 0, 0, 42, 0, 0, 0, 42
"d:\GitRepo\archive\C++[class]\3 - 2022.9.22\8.cpp", "C++", 0, 0, 45, 0, 0, 0, 45
"d:\GitRepo\archive\C++[class]\4 - 2022.9.29\1.cpp", "C++", 0, 0, 50, 0, 0, 1, 51
"d:\GitRepo\archive\C++[class]\4 - 2022.9.29\2.cpp", "C++", 0, 0, 37, 0, 0, 1, 38
"d:\GitRepo\archive\C++[class]\4 - 2022.9.29\3.cpp", "C++", 0, 0, 45, 0, 0, 1, 46
"d:\GitRepo\archive\C++[class]\4 - 2022.9.29\4.cpp", "C++", 0, 0, 49, 0, 0, 1, 50
"d:\GitRepo\archive\C++[class]\4 - 2022.9.29\5.cpp", "C++", 0, 0, 54, 0, 0, 1, 55
"d:\GitRepo\archive\C++[class]\4 - 2022.9.29\6.cpp", "C++", 0, 0, 52, 0, 0, 1, 53
"d:\GitRepo\archive\C++[class]\4 - 2022.9.29\7.cpp", "C++", 0, 0, 57, 0, 0, 1, 58
"d:\GitRepo\archive\C++[class]\4 - 2022.9.29\8.cpp", "C++", 0, 0, 82, 0, 0, 2, 84
"d:\GitRepo\archive\C++[class]\4 - 2022.9.29\9.cpp", "C++", 0, 0, 94, 0, 0, 2, 96
"d:\GitRepo\archive\C++[class]\5 - 2022.10.13\1.cpp", "C++", 0, 0, 36, 0, 0, 1, 37
"d:\GitRepo\archive\C++[class]\5 - 2022.10.13\2.cpp", "C++", 0, 0, 34, 0, 0, 1, 35
"d:\GitRepo\archive\C++[class]\5 - 2022.10.13\3.cpp", "C++", 0, 0, 37, 0, 0, 1, 38
"d:\GitRepo\archive\C++[class]\5 - 2022.10.13\4.cpp", "C++", 0, 0, 37, 0, 0, 1, 38
"d:\GitRepo\archive\C++[class]\5 - 2022.10.13\5.cpp", "C++", 0, 0, 37, 0, 0, 1, 38
"d:\GitRepo\archive\C++[class]\5 - 2022.10.13\6.cpp", "C++", 0, 0, 20, 0, 0, 1, 21
"d:\GitRepo\archive\C++[class]\5 - 2022.10.13\MyQueue.h", "C++", 0, 0, 43, 0, 0, 3, 46
"d:\GitRepo\archive\C++[class]\guess-qst\20220908-maze.cpp", "C++", 0, 0, 67, 0, 0, 0, 67
"d:\GitRepo\archive\C++[class]\guess-qst\20220908-maze.md", "Markdown", 0, 18, 0, 0, 0, 7, 25
"d:\GitRepo\archive\C++[class]\guess-qst\20220915-moon.cpp", "C++", 0, 0, 22, 0, 0, 1, 23
"d:\GitRepo\archive\C++[class]\guess-qst\20220915-moon.md", "Markdown", 0, 5, 0, 0, 0, 4, 9
"d:\GitRepo\archive\C++[class]\guess-qst\20220922-calculator.cpp", "C++", 0, 0, 58, 0, 0, 1, 59
"d:\GitRepo\archive\C++[class]\guess-qst\20220922-calculator.md", "Markdown", 0, 7, 0, 0, 0, 4, 11
"d:\GitRepo\archive\C++[class]\guess-qst\20220929-encryption.cpp", "C++", 0, 0, 91, 0, 0, 1, 92
"d:\GitRepo\archive\C++[class]\guess-qst\20220929-encryption.md", "Markdown", 0, 23, 0, 0, 0, 12, 35
"d:\GitRepo\archive\C++[class]\guess-qst\20221013-encryption-chn.cpp", "C++", 0, 0, 78, 0, 0, 2, 80
"d:\GitRepo\archive\C++[class]\guess-qst\20221013-encryption-chn.md", "Markdown", 0, 18, 0, 0, 0, 9, 27
"d:\GitRepo\archive\C++[class]\template\1.cpp", "C++", 0, 0, 0, 0, 0, 1, 1
"d:\GitRepo\archive\C++[class]\template\10.cpp", "C++", 0, 0, 0, 0, 0, 1, 1
"d:\GitRepo\archive\C++[class]\template\2.cpp", "C++", 0, 0, 0, 0, 0, 1, 1
"d:\GitRepo\archive\C++[class]\template\3.cpp", "C++", 0, 0, 0, 0, 0, 1, 1
"d:\GitRepo\archive\C++[class]\template\4.cpp", "C++", 0, 0, 0, 0, 0, 1, 1
"d:\GitRepo\archive\C++[class]\template\5.cpp", "C++", 0, 0, 0, 0, 0, 1, 1
"d:\GitRepo\archive\C++[class]\template\6.cpp", "C++", 0, 0, 0, 0, 0, 1, 1
"d:\GitRepo\archive\C++[class]\template\7.cpp", "C++", 0, 0, 0, 0, 0, 1, 1
"d:\GitRepo\archive\C++[class]\template\8.cpp", "C++", 0, 0, 0, 0, 0, 1, 1
"d:\GitRepo\archive\C++[class]\template\9.cpp", "C++", 0, 0, 0, 0, 0, 1, 1
"d:\GitRepo\archive\C++[class]\template\思考题.cpp", "C++", 0, 0, 0, 0, 0, 1, 1
"d:\GitRepo\archive\CodeForces\Avito Cool Challenge 2018\33792580_AC_15ms_1044kB.cpp", "C++", 0, 0, 10, 0, 0, 0, 10
"d:\GitRepo\archive\CodeForces\Div.2\117\37051412_AC_62ms_620kB.cpp", "C++", 0, 0, 33, 0, 3, 0, 36
"d:\GitRepo\archive\CodeForces\Div.2\144\37068400_AC_30ms_56kB.cpp", "C++", 0, 0, 31, 0, 2, 0, 33
"d:\GitRepo\archive\CodeForces\Div.2\157\37114631_AC_30ms_8kB.cpp", "C++", 0, 0, 17, 0, 2, 0, 19
"d:\GitRepo\archive\CodeForces\Div.2\197\34668956_AC_30ms_8kB.cpp", "C++", 0, 0, 34, 0, 1, 2, 37
"d:\GitRepo\archive\CodeForces\Div.2\197\36997606_AC_62ms_8kB.cpp", "C++", 0, 0, 18, 0, 2, 0, 20
"d:\GitRepo\archive\CodeForces\Div.2\241\34639371_AC_31ms_8kB.cpp", "C++", 0, 0, 58, 0, 3, 2, 63
"d:\GitRepo\archive\CodeForces\Div.2\245\37047576_AC_30ms_4kB.cpp", "C++", 0, 0, 29, 0, 2, 0, 31
"d:\GitRepo\archive\CodeForces\Div.2\258\37136079_AC_46ms_1584kB.cpp", "C++", 0, 0, 32, 0, 3, 0, 35
"d:\GitRepo\archive\CodeForces\Div.2\292\37046311_AC_15ms_4kB.cpp", "C++", 0, 0, 20, 0, 2, 0, 22
"d:\GitRepo\archive\CodeForces\Div.2\292\37049161_AC_15ms_4kB.cpp", "C++", 0, 0, 22, 0, 2, 0, 24
"d:\GitRepo\archive\CodeForces\Div.2\298\37023075_AC_109ms_788kB.cpp", "C++", 0, 0, 23, 0, 2, 0, 25
"d:\GitRepo\archive\CodeForces\Div.2\301\36996950_AC_15ms_8kB.cpp", "C++", 0, 0, 18, 0, 2, 0, 20
"d:\GitRepo\archive\CodeForces\Div.2\301\37024071_AC_31ms_268kB.cpp", "C++", 0, 0, 38, 0, 2, 0, 40
"d:\GitRepo\archive\CodeForces\Div.2\303\37114209_AC_15ms_52kB.cpp", "C++", 0, 0, 31, 0, 2, 0, 33
"d:\GitRepo\archive\CodeForces\Div.2\303\37115072_AC_62ms_1576kB.cpp", "C++", 0, 0, 35, 0, 5, 0, 40
"d:\GitRepo\archive\CodeForces\Div.2\353\35018202_AC_15ms_8kB.cpp", "C++", 0, 0, 24, 0, 1, 2, 27
"d:\GitRepo\archive\CodeForces\Div.2\381\34642545_AC_30ms_8kB.cpp", "C++", 0, 0, 27, 0, 1, 2, 30
"d:\GitRepo\archive\CodeForces\Div.2\397\35016120_AC_15ms_8kB.cpp", "C++", 0, 0, 31, 0, 1, 2, 34
"d:\GitRepo\archive\CodeForces\Div.2\402\36998165_AC_109ms_2356kB.cpp", "C++", 0, 0, 31, 0, 2, 0, 33
"d:\GitRepo\archive\CodeForces\Div.2\439\33793989_AC_15ms_1040kB.cpp", "C++", 0, 0, 22, 0, 0, 0, 22
"d:\GitRepo\archive\CodeForces\Div.2\496\34248379_AC_15ms_400kB.cpp", "C++", 0, 0, 21, 0, 0, 0, 21
"d:\GitRepo\archive\CodeForces\Div.2\510\33793475_AC_15ms_1088kB.cpp", "C++", 0, 0, 47, 0, 0, 0, 47
"d:\GitRepo\archive\CodeForces\Div.2\567\34638690_AC_31ms_4904kB.cpp", "C++", 0, 0, 92, 0, 8, 6, 106
"d:\GitRepo\archive\CodeForces\Div.2\569\34668098_AC_77ms_396kB.cpp", "C++", 0, 0, 27, 0, 1, 2, 30
"d:\GitRepo\archive\CodeForces\Div.2\614\34247730_AC_15ms_8kB.cpp", "C++", 0, 0, 9, 0, 0, 0, 9
"d:\GitRepo\archive\CodeForces\Div.2\658\34601241_AC_15ms_12kB.cpp", "C++", 0, 0, 25, 0, 0, 0, 25
"d:\GitRepo\archive\CodeForces\Div.2\658\34602438_AC_31ms_392kB.cpp", "C++", 0, 0, 27, 0, 0, 0, 27
"d:\GitRepo\archive\CodeForces\Div.2\664\34992067_AC_15ms_4kB.cpp", "C++", 0, 0, 37, 0, 1, 3, 41
"d:\GitRepo\archive\CodeForces\Div.2\754\A.cpp", "C++", 0, 0, 19, 0, 1, 1, 21
"d:\GitRepo\archive\CodeForces\Div.2\773\A.cpp", "C++", 0, 0, 21, 0, 1, 1, 23
"d:\GitRepo\archive\CodeForces\Div.2\825\A.cpp", "C++", 0, 0, 27, 0, 0, 0, 27
"d:\GitRepo\archive\CodeForces\Div.2\825\B-1.cpp", "C++", 0, 0, 21, 0, 0, 0, 21
"d:\GitRepo\archive\CodeForces\Div.2\825\B-2.cpp", "C++", 0, 0, 18, 0, 0, 0, 18
"d:\GitRepo\archive\CodeForces\Div.2\825\C1.cpp", "C++", 0, 0, 19, 0, 0, 0, 19
"d:\GitRepo\archive\CodeForces\Div.2\Pi\35016031_AC_62ms_792kB.cpp", "C++", 0, 0, 28, 0, 1, 2, 31
"d:\GitRepo\archive\CodeForces\Div.3\753\A.cpp", "C++", 0, 0, 22, 0, 1, 1, 24
"d:\GitRepo\archive\CodeForces\Div.3\753\B.cpp", "C++", 0, 0, 27, 0, 1, 1, 29
"d:\GitRepo\archive\CodeForces\Div.3\820\A.cpp", "C++", 0, 0, 17, 0, 0, 1, 18
"d:\GitRepo\archive\CodeForces\Div.3\820\B.cpp", "C++", 0, 0, 29, 0, 0, 0, 29
"d:\GitRepo\archive\CodeForces\Div.3\820\C.cpp", "C++", 0, 0, 31, 0, 0, 0, 31
"d:\GitRepo\archive\CodeForces\Div.3\820\D.cpp", "C++", 0, 0, 19, 0, 0, 1, 20
"d:\GitRepo\archive\CodeForces\Div.3\826\A.cpp", "C++", 0, 0, 28, 0, 0, 0, 28
"d:\GitRepo\archive\CodeForces\Div.3\826\B.cpp", "C++", 0, 0, 20, 0, 0, 0, 20
"d:\GitRepo\archive\CodeForces\Div.3\826\C.cpp", "C++", 0, 0, 47, 0, 0, 0, 47
"d:\GitRepo\archive\CodeForces\Div.4\827\A.cpp", "C++", 0, 0, 15, 0, 0, 0, 15
"d:\GitRepo\archive\CodeForces\Div.4\827\B.cpp", "C++", 0, 0, 25, 0, 0, 0, 25
"d:\GitRepo\archive\CodeForces\Div.4\827\C.cpp", "C++", 0, 0, 25, 0, 0, 0, 25
"d:\GitRepo\archive\CodeForces\Div.4\827\D.cpp", "C++", 0, 0, 30, 0, 0, 0, 30
"d:\GitRepo\archive\CodeForces\Div.4\827\E.cpp", "C++", 0, 0, 33, 0, 2, 0, 35
"d:\GitRepo\archive\CodeForces\Div.4\827\F.cpp", "C++", 0, 0, 31, 0, 43, 0, 74
"d:\GitRepo\archive\CodeForces\Educational Round\11\E.cpp", "C++", 0, 0, 38, 0, 1, 3, 42
"d:\GitRepo\archive\CodeForces\Educational Round\14\34247483_AC_15ms_8kB.cpp", "C++", 0, 0, 18, 0, 0, 0, 18
"d:\GitRepo\archive\CodeForces\Educational Round\35\F.cpp", "C++", 0, 0, 39, 0, 0, 3, 42
"d:\GitRepo\archive\CodeForces\Global Round\11\A.cpp", "C++", 0, 0, 29, 0, 1, 1, 31
"d:\GitRepo\archive\CodeForces\Global Round\23\A.cpp", "C++", 0, 0, 20, 0, 0, 0, 20
"d:\GitRepo\archive\CodeForces\Global Round\23\B.cpp", "C++", 0, 0, 28, 0, 0, 0, 28
"d:\GitRepo\archive\CodeForces\Global Round\23\C.cpp", "C++", 0, 0, 32, 0, 1, 0, 33
"d:\GitRepo\archive\CodeForces\Good Bye 2017\D.cpp", "C++", 0, 0, 24, 0, 0, 2, 26
"d:\GitRepo\archive\GPLT\L2\041插松枝.cpp", "C++", 0, 0, 64, 0, 4, 0, 68
"d:\GitRepo\archive\GPLT\L2\041插松枝.md", "Markdown", 0, 0, 0, 0, 0, 1, 1
"d:\GitRepo\archive\LeetCode\59.cpp", "C++", 0, 0, 18, 0, 2, 0, 20
"d:\GitRepo\archive\Luogu\dp\P1020.cpp", "C++", 0, 0, 20, 0, 0, 0, 20
"d:\GitRepo\archive\Luogu\graph\shortest-path\P1119.cpp", "C++", 0, 0, 41, 0, 0, 0, 41
"d:\GitRepo\archive\Luogu\graph\shortest-path\P1141.cpp", "C++", 0, 0, 45, 0, 0, 0, 45
"d:\GitRepo\archive\Luogu\graph\shortest-path\P1144.cpp", "C++", 0, 0, 0, 0, 0, 1, 1
"d:\GitRepo\archive\Luogu\graph\shortest-path\P1359.cpp", "C++", 0, 0, 22, 0, 0, 0, 22
"d:\GitRepo\archive\Luogu\graph\shortest-path\P1462.cpp", "C++", 0, 0, 0, 0, 0, 1, 1
"d:\GitRepo\archive\Luogu\graph\shortest-path\P1522.cpp", "C++", 0, 0, 0, 0, 0, 1, 1
"d:\GitRepo\archive\Luogu\graph\shortest-path\P1629.cpp", "C++", 0, 0, 41, 0, 0, 0, 41
"d:\GitRepo\archive\Luogu\graph\shortest-path\P3371.cpp", "C++", 0, 0, 49, 0, 0, 0, 49
"d:\GitRepo\archive\Luogu\graph\shortest-path\P4779.cpp", "C++", 0, 0, 49, 0, 0, 0, 49
"d:\GitRepo\archive\Match\220710-RoboCom\A.cpp", "C++", 0, 0, 19, 0, 0, 0, 19
"d:\GitRepo\archive\Match\220710-RoboCom\B.cpp", "C++", 0, 0, 27, 0, 0, 0, 27
"d:\GitRepo\archive\Match\220710-RoboCom\C.cpp", "C++", 0, 0, 49, 0, 1, 0, 50
"d:\GitRepo\archive\Match\220710-RoboCom\E.cpp", "C++", 0, 0, 47, 0, 9, 0, 56
"d:\GitRepo\archive\Match\221008-校赛\A.cpp", "C++", 0, 0, 19, 0, 0, 0, 19
"d:\GitRepo\archive\Match\221008-校赛\B.cpp", "C++", 0, 0, 16, 0, 0, 0, 16
"d:\GitRepo\archive\Match\221008-校赛\D.cpp", "C++", 0, 0, 37, 0, 0, 0, 37
"d:\GitRepo\archive\Match\221008-校赛\E.cpp", "C++", 0, 0, 31, 0, 1, 0, 32
"d:\GitRepo\archive\gitbashcmd.md", "Markdown", 0, 24, 0, 0, 0, 3, 27
"d:\GitRepo\data-structure\binary-tree.cpp", "C++", 0, 0, 42, 0, 6, 3, 51
"d:\GitRepo\data-structure\list.cpp", "C++", 0, 0, 163, 0, 16, 7, 186
"d:\GitRepo\data-structure\queue.cpp", "C++", 0, 0, 0, 0, 0, 1, 1
"d:\GitRepo\data-structure\stack.cpp", "C++", 0, 0, 76, 0, 13, 13, 102
"d:\GitRepo\desktop.ini", "Ini", 4, 0, 0, 0, 0, 1, 5
"d:\GitRepo\template\graph\minimum-spanning-tree\kruskal.cpp", "C++", 0, 0, 0, 0, 0, 1, 1
"d:\GitRepo\template\graph\minimum-spanning-tree\kruskal.md", "Markdown", 0, 0, 0, 0, 0, 1, 1
"d:\GitRepo\template\graph\minimum-spanning-tree\prim.cpp", "C++", 0, 0, 0, 0, 0, 1, 1
"d:\GitRepo\template\graph\minimum-spanning-tree\prim.md", "Markdown", 0, 0, 0, 0, 0, 1, 1
"d:\GitRepo\template\graph\shortest-path\README.md", "Markdown", 0, 11, 0, 0, 0, 2, 13
"d:\GitRepo\template\graph\shortest-path\bellman-ford.cpp", "C++", 0, 0, 36, 0, 0, 0, 36
"d:\GitRepo\template\graph\shortest-path\bellman-ford.md", "Markdown", 0, 4, 0, 0, 0, 3, 7
"d:\GitRepo\template\graph\shortest-path\bfs.cpp", "C++", 0, 0, 0, 0, 0, 1, 1
"d:\GitRepo\template\graph\shortest-path\bfs.md", "Markdown", 0, 0, 0, 0, 0, 1, 1
"d:\GitRepo\template\graph\shortest-path\dfs.cpp", "C++", 0, 0, 0, 0, 0, 1, 1
"d:\GitRepo\template\graph\shortest-path\dfs.md", "Markdown", 0, 0, 0, 0, 0, 1, 1
"d:\GitRepo\template\graph\shortest-path\dijkstra-I.cpp", "C++", 0, 0, 35, 0, 0, 0, 35
"d:\GitRepo\template\graph\shortest-path\dijkstra-II.cpp", "C++", 0, 0, 51, 0, 0, 0, 51
"d:\GitRepo\template\graph\shortest-path\dijkstra.md", "Markdown", 0, 8, 0, 0, 0, 7, 15
"d:\GitRepo\template\graph\shortest-path\floyd.cpp", "C++", 0, 0, 33, 0, 0, 0, 33
"d:\GitRepo\template\graph\shortest-path\floyd.md", "Markdown", 0, 3, 0, 0, 0, 3, 6
"d:\GitRepo\template\graph\shortest-path\spfa.cpp", "C++", 0, 0, 47, 0, 0, 0, 47
"d:\GitRepo\template\graph\shortest-path\spfa.md", "Markdown", 0, 4, 0, 0, 0, 4, 8
"d:\GitRepo\template\math\cantor.cpp", "C++", 0, 0, 25, 0, 0, 1, 26
"d:\GitRepo\template\math\cantor.md", "Markdown", 0, 0, 0, 0, 0, 1, 1
"d:\GitRepo\template\math\quick-pow.cpp", "C++", 0, 0, 22, 0, 0, 0, 22
"d:\GitRepo\template\math\quick-pow.md", "Markdown", 0, 3, 0, 0, 0, 2, 5
"d:\GitRepo\template\string\kmp.cpp", "C++", 0, 0, 0, 0, 0, 1, 1
"d:\GitRepo\template\string\kmp.md", "Markdown", 0, 0, 0, 0, 0, 1, 1
"d:\GitRepo\template\tmp.cpp", "C++", 0, 0, 50, 0, 12, 0, 62
"d:\GitRepo\un-archived\Test.cpp", "C++", 0, 0, 15, 0, 0, 1, 16
"Total", "-", 4, 164, 5843, 257, 276, 248, 6792